┌─────────────────────┐                                
│                     ├──────────────────────┬────────┐
│                     │                      │        │
│                     │                      │        │
│             │       │        │             │       ─┤
│       ──────┤       │        │             │       X│
│             │       │        │             │       ─┤
│             │       │        │    $ $ $    │        │
│             │       │        └─────────────┤        │
│             │       │                      │      ┌─┘
│             │       │                      │      │  
├───────   ^  │       │                      │      │  
│             │       │                      │      │  
├─            │       └───────               │      └─┐
│E            │                              └─┐      │
├─            │                                │      │
│             │                                │      │
├─────────────┘                   ─────────────┘      │
│                                                     │
│                                                     │
└───────┬───────────────────────────────────────      │
        │              ^ ^ ^ ♥ ^ ^ ^ ^                │
        │  $ $ $     ^ ^ ^ ^ ^ ^ ^ ^   ♥              │
        └─────────────────────────────────────────────┘