             ┌──┬──┐        ┌─┬─┬────────────────┐     
          ┌──┘  │  └─┐    ┌─┘ │E│    ^^^^^^^     │     
          │     │    └────┘   │ │    ^♥ ♥ ♥^     │     
      ┌───┘     │       ♥ ♥   │ │    ^^^^^^^     │     
┌─────┘         │   ──────────┘ │                │     
│               │               └──────          │     
│  ♥            │   ──────────┐                  │     
├──────         │             │  ┌─────   ^  ^   │     
│           │   └─┬───────────┘  │               │     
│    ┌─     │     │              │  $  $         │     
│  $ │      │     │              ├───────────────┤     
│    │      │     │              │               │     
│  ♥ │^^   ^│     │   ───────────┘               │     
│    │      │     │                              │     
│  $ │^  ^^ │     ├─────────────────────      ┌──┘     
│    │      │     │   $♥                      │        
│    │^^^   │     │   ♥$                      │        
│  ♥ │      │     └────────────────────       └┐       
│    │  $$  │                                  └──────┐
├─   │  $$  │                                         │
│X   │  $$  │                                         │
└────┴──────┴─────────────────────────────────┐     ┌─┘
                                              └─────┘  