              ┌────┬─────┬───┐                
              │    │     │   └┐               
              │    │     │    │               
            ┌─┘    │     │    └─┐             
       ┌────┘            │      └─────┐       
 ┌─────┘ ♥♥$$      │     │   ♥♥♥      └──────┐
 │       $$♥♥      │     │                   │
 ├┬────────────────┤     ├──────────── ─────┬┤
 ├┘                │     │                  └┤
 │X                │     │                  E│
 ├┐                │     │                  ┌┤
 ├┴─── ────────────┤     ├──────────── ─────┴┤
 │$^               │     │                   │
 └──────┐          │     │                   │
        └───┐      │     │                   │
            │      │     │             ┌─────┘
            └──┐                  ┌────┘      
               │   │     │        │           
               │   │     │     ┌──┘           
               └───┴─────┴─────┘              