┌─────────────────────┬───────────────┐
│                     │               │
│                     │               │
├──                   │               │
│X                    │               │
├──             │     │       ^       │
│               │     │       │       │
│               │     │       │       │
├───────────────┘     │       │       │
│                     │       │       │
│             $ ^     │       │       │
│                     │       │   $   │
│          ───────────┘       │       │
│                             │       │
│                             │       │
│                    $        │       │
├─────────────────────────────┘       │
│                                     │
│                                     │
│               ┌─────────────────────┘
│               │                      
│               │                      
│               │                      
│  │ E │        │                      
└──┴───┴────────┘                      