┌─────┬─────────┬────────────────────────────────────────┐
│     │┼┼┼┼┼┼┼┼┼│                                        │
│   ┌─┴─────────┴┐                      ┌─────┐ ┌────┐   │
│   │            │                      │┼┼┼┼┼│ │┼┼┼┼│   │
│   │            │                     ┌┴─────┘ └────┤   │
│   │   ┌───┐    │                     │             │   │
│   │   │ X │    │                     │    ┌── ─┐   │   │
│   │   └─^─┘    │                     │    │  X │   │   │
│   │^^^^^^^^^^^ │                     │    └────┘   │   │
│   │^^^^^^^^^^^ │                     │             │   │
│   └───── ──────┘                     └─────────────┘   │
│                $     ┌──┬─┬──┐        $                │
│            $$$       │  │E│  │         $$$             │
│         $$$          │       │             $$$         │
│                   ┌──┘       └──┐                      │
└──┐                │ ♥         ♥ │                   ┌──┘
   │                └──┐       ┌──┘                   │   
   │                   └─  ────┘                      │   
┌──┘                   ♥♥♥♥♥♥♥♥                       └──┐
│     ┌──────────────────────────────────────────┐       │
│     ├──────────────────────────────────────────┤       │
│     │                                          │       │
│     └──────────────────────────────────  ──────┘       │
│                          ♥                             │
└────────────────────────────────────────────────────────┘