┌───────┬─────────────────────┬───────┬──────────┐   ┌────┬─┬────┐
│       │                     │  $$$$ │          │   │    │X│    │
│       │                     │       │          │   │           │
├─      │                     │       │          └───┤           │
│E      │                     │   ^   │              │           │
├─      │            │        │       │     │        └──────┐    │
│       │            │        │       │     │               │^   │
│       │            │        │       │     │               │    |
│       │            │        │       │     │               │   ^│
│       │            │                │     │               │    │
│                    │      ──────────┘     │               │^   │
│                    │                      │        │      │    │
└────────────────────┤                      │ $♥♥♥$  │      │   ^│
                     │         ┌────────────┴────────┤      │    │
                     │         │                     │      │    │
                     │         │                     │           │
                     └─────────┘                     └───────────┘