              ┌─────┬─┬──────┬───────────────────────────────────┐   
              │ ♥ $ │X│ $♥   │                      ♥♥♥♥♥♥♥♥     │   
              │              │            ──┐       $$$$$$$$     │   
              │         │    │    │         │           ♥♥┌──────┘   
        ┌──┐  └───┐     │    │    │         │     ┌───────┘          
┌───────┘  └┐     │     │    │    │    ^    │     │                  
│   $$$$    │     │     │    │    │         └─────┴┐                 
│   $$$$    │     │     │    │    │   ^   ^        │                 
│           └─────┘     │    │    │   ^  ^    ^  ^ │                 
└────┐                  │    │    │      ^         └──────┐          
     │            │     │    │    │         ^   ^         │          
     │            │     │    │    │    ^           ^      └─────────┐
     └─────┐      │     │    │    │        ^  ^   ^  ^              │
           │      │     │    │    │               ^                 │
        ┌──┘      │     │    │    └───────────────────────────┐     │
        │         │     │    │                             ♥  │     │
    ┌───┘         │     │    └──────────────────────────   ♥  │     │
    │             │     │                                  ♥  │     │
    │             │ ^   │                                     │     │
    │             │     └─────────────────────────────────────┤     │
    └──────┐      │                                           │     │
           │      └──────────────────              ┌──┐      ─┘     │
           │                             │E│     ┌─┘  └┐            │
           └────────┐        ┌───────────┴─┴─────┘     └────────────┘
                    │ ♥ ┌────┘                                       
                    └───┘                                            