   ┌─┬─────┬─────┐
   │$│♥    │     │
 ┌─┘ │  │  │  │ ─┤
┌┘$ ♥ $ │     │ X│
│   ────┴─────┴──┤
│$ ♥  $   $     ♥│
└┬────────  ┌────┤
 │     ♥   $│   E│
┌┘ ─────────┘   ─┤
│   ♥            │
└───────────┐^^^^│
            │ $ ┌┘
            └───┘ 