   ┌─────┐                                       
   │  ♥  │ ┌───────────┐                         
 ┌─┘     └─┘     ♥ ♥ ♥ │                         
 │             ┌───────┘                         
 │             └───────┐                         
┌┘                     │                         
└────┐          │      └──────────┐              
     │          │                 └────────────┬┐
     │          └─────────────┐                └┤
     │                        │                X│
     │                        │                ┌┤
     └──────┐                 └────────────────┴┤
            └┐    │                    $♥$♥$♥   │
             │    │               ┌─────────────┘
             │    │       │       │              
      ┌──────┘    │       │       │              
    ┌─┘           │       │       └───┐          
    │           ──┘       │           │          
    │ $  ^          ──────┤           │          
    │                     │           └┐         
    └───────┐             └─────       │         
            └────┐               ┌─────┘         
                 │       ┌──┐ ♥♥ │               
                 │  │E│  │  │ ♥♥ │               
                 └──┴─┴──┘  └────┘               