            ┌───┬───┐       ┌──┬─────────┐
          ┌─┘♥♥ │   └─┐   ┌─┘  │         │
  ┌───────┘     │     └───┘    │         │
┌─┘             │              │   │    ─┤
│$              │      ^^│     │   │    E│
│$       │      │        │     │   │    ─┤
└─┐      │      │   ^^   │     │   │  ♥♥ │
  │      │      │^^      │     │   └─────┤
  └┐     │      │        │     │         │
   │     │      │      ♥ │     │         │
   │     │      │    ^^  │     └───────  │
 ┌─┘     │      │        │               │
┌┘♥      │      │ ♥      │               │
│$♥      │      │      ^^│               │
└─┐      │      │        └───────────────┤
  └┐     │      │                    ♥   │
   │     │      └───────────         ♥♥  │
   │     │                           ♥♥  │
   └──┐  └───────────────────────────────┤
      │                                  │
      │                             │X│  │
      └─────┐♥┌──┐ ♥         ┌──────┴─┴──┘
            └─┘  │♥ ♥   ^^^┌─┘            
                 └───────┐♥│              
                         └─┘              